111111111111
10P000000001
111111111101
100000001EC1
111111111111