11111111111111111
10P00000100000001
1000C000100000001
10000000100000001
1000C0001C0000001
10000000000000001
1000C000000000001
10000000000000001
1001C100000000001
1001E100000000001
11111111111111111