1111111111111111111111111111
10P0000000000000010000000001
10000000000000000100000C0001
1000001111111111110000000001
1000000000C00000011111000001
1000C00000000000000000000001
1011111111111111111000000001
10000001000000000000C0000001
100000010000000C000000000001
1000011110000C00000000000001
1000000010000000000011111001
1000000010000000000000000001
100000C0100000000000E0000001
1111111111111111111111111111